NO assets/textures/wolfenstein/grey_stone.png
SO assets/textures/wolfenstein/purple_stone.png
WE assets/textures/wolfenstein/red_brick.png
EA assets/textures/wolfenstein/wood.png

F 18,53,25
C 153,204,255

111111111111
1         11
111111111111
100000010011
10S000000001
111111111111
11         1
111111111111
