NO      ./assets/bluestone.xpm    
SO      ./assets/colorstone.xpm

EA      ./assets/purplestone.xpm     
WE      ./assets/redbrick.xpm    

C       87,170,230
F       145,132,62

1111111111111111111111111111
1000000000000000000000000001
1000000000000000000000000001
1000000000000000000000000001
1110001111011100000000000001
1000E00011000000000000000001
1000000111000000000000000001
1000000000000000000000000001
1000000000000000000000000001
1000000000000000000000000001
1000000000000000000000000001
1000000000000000000000000001
1110001111011100000000000001
1000000011000000000000000001
1000000111000000000000000001
1000000000000000000000000001
1000000000000000000000000001
1111111111111111111111111111