NO      ./assets/north.png
SO      ./assets/south.png
EA      ./assets/west.png 
WE      ./assets/east.png    

C       87,170,230
F       165,122,142

1111111111111111111111111111
1000000000000000000000000001
1000000000000000000011111001
1000000000000000000010001001
1110001111011100000011101001
1000N00011000111000000000001
1000000111000001110011111111
1000000000000000010010000001
1000000000000000010010000001
1000000000000000010010000001
1000000000000000010011110111
1000000000000000000000000001
1110001111011100000000000001
1000000011000000000000000001
1000000111000000000000000001
1000000000000000000000000001
1000000000000000000000000001
1111111111111111111111111111