NO      ./assets/north.png
SO      ./assets/south.png
EA      ./assets/east.png
WE      ./assets/west.png  

C       87,170,230
F       145,132,62

        1111111111111111111111111
        1000000000110000000000001
        1011000001110000000000001
        1001000000000000000000001
111111111011000001110000000000001
100000000011000001110111111111111
11110111111111011100000010001
11110111110001011101010010001
11000000110111011100000010001
1000E000000000001100000010001
10000000000010001101010010001
11000011111010111111011110001
1111011  1100001  11111101001
1111111  1111111  11111111111