NO      ./assets/bluestone.xpm    
SO      ./assets/colorstone.xpm
WE      ./assets/redbrick.xpm    

EA      ./assets/purplestone.xpm     

  

F 220,100,0
C 225,30,0
  
        1110000000000011111111111  
        1000000000110000000000001
        1011000001110000000000000001
        1001000000000000000000001
111111111011000001110000000000001
100000000011000001110111111111111
11110111111111011100000010001
11110111111111011101010010001
11000000110101011100000010001
10000000000000001100000010001
10000000000000001101010010001
11000001110101011111011110N0111
11110111 1110101 101111010001
1111001  11   11 111111111111