NO      ./assets/bluestone.xpm    
SO      ./assets/colorstone.xpm

EA      ./assets/purplestone.xpm     
WE      ./assets/redbrick.xpm    

C       87,170,230
F       145,132,62

111111111111111
100000000100001
100000000100001
100000000100001
111000111101111
1000E0001100001
100000011100001
100000000100001
100000000100001
111111111111111
