NO      ./assets/north.png
SO      ./assets/south.png
EA      ./assets/east.png     
WE      ./assets/west.png    

C       87,170,230
F       145,132,62

111111111111111
100000000000001
100010000100001
100000000100001
111000111101101
1000N0001100001
100000011100001
100000000100001
100000000000001
111111111111111
