NO ./texture/test/north_texture.png
SO ./texture/test/south_texture.png
WE ./texture/test/west_texture.png
EA ./texture/test/east_texture.png
F 123,123,123
C 255,255,255

        111111111111111111111111
        10000000001100000000N0001
        1011000001110000000000001
        1001000000000000000000001
111111111011000001110000000000001
100000000011000001110111110111111
11110111111111011100000010001
11110111111111011101010010001
11000000110101011100000010001
10000000000000001100000010001
10000000000000001101010010001
1100000111010101111101111000111
11110111 1110101 101111010001
11111111 1111111 11111111111
