NO ./texture/test/north_texture.png
SO ./texture/test/south_texture.png
WE ./texture/test/west_texture.png
EA ./texture/test/east_texture.png

F 20,10,0
C 4,67,137


           1
          111
         11011
        1100011
       110000011
      11010001011
     1100001000011
    111110000011111
   11100100000100111
  1100000000000000011
 110000000000000000011
11000000000000000000011
11000000000000000000011
11001000001001000010011
11001000001001000010011
11001000001001000010011
11000000010001000000011
11000000000000000000011
11001111100001111100011
11001000100001000100011
11001000100001000100011
11001101100001101100011
11000000000000000000011
11000000000000000000011
 1100000000N0000000011
  1100101100011000011
   11010000000010011
    110001000001011
     1111100111111
      11000000011
       110010011
        1100011
         11011
          111
           1

